size = 12,12
010000000010
010000000010
010000000010
010000000010
010000000010
010000000010
001000000100
000111111000
001000000100
010000000010
100000000001
100000000001